R 1000 1000
NO ./textures/wall1v.xpm
SO ./textures/wall1v.xpm
WE ./textures/wall1v.xpm
EA ./textures/wall1v.xpm


S ./textures/cat.xpm

F 105, 105,105
C 211, 211, 211



         1111111111111111111111111
         1000000000110000000000001
         1011000001110000002000001
        11001000000000000000000001
1111111110110000011100000000000011
100000000011000001110111111111111
11110111111111011100000010001
11110111111111011101010010001
110000001101010111000000100011
100020000000000011000W00010001
100000000000000011010100100011
110000011101010111110111100111
11110111 1110101 101111010001
11111111 1111111 111111111111
