R 300 300
NO ./textures/wall1h.xpm
SO ./textures/wall2h.xpm
WE ./textures/wall3h.xpm
EA ./textures/wall4h.xpm


S ./textures/cat.xpm

F 254, 0,32
C 242, 123, 12



11111111111111111111111111111111111111111111
100N0000000000000000000000000000000000000001
10000000000000000000000100000000000000000001
10000000000000000000000100000000000000000001
10000000000000000000000100000000000000000001     11111
10000000000000001111111100000000000000000001     10001
10000000000000000000000000000000000000000001     11111
10000000000000000000000000000000000000000001
10000000000011100000000000000000000000000001
11110000000011100000000000000000000000001111
   1000000000001110000000000000000000000001
111100000000000000000000000000000000000001111
10000000000000000000000000000000000000000001
10000000000000000000000000000000000000000001
10000000000000000000000000000000000000000001
10000000000000000000000000000000000000000001
10000000000000000000000000000000000000000001
10000000000000000000000000000000000000000001
10000000000000000000001100000000000000000001
10000000000000000000000000000000000000000001
10000000000000000000000000000000000000000001
10000000000000000000000100000000000000000001
10000100000000000000000000000000000000000001
10001100000000000000000000000000000000000001
10000000000000000000000000000000000000000001
10000000000000000000000000000000000000000001
10000000000000000000000000000000000000000001
11111111111111111111111111111111111111111111
