R 1200 1000
WE ./textures/selfie_catto.xpm
SO ./textures/police_doggo.xpm
NO ./textures/catto.xpm
EA ./textures/friend_doggo.xpm


S ./textures/cat.xpm

F 105, 105,105
C 211, 211, 211


1111111111111111111111111111111111
1010000000000000000000000000000001
1110000000000000000000000000000001
1000000000000000000000100000000011
10000E0000000000000000010000000001
1000000000000000000000110000000001
1000000000000001100001011111000001
1000000000111111100001000000000001
1000000000100011000010000000000011
1000000000100001111111000000000001
1000000000000000000001000000000001
1000000111111111111111000000000001
1000000000000000000000000000000001
1000000000000000000000000000000001
1000000000000000000000000000000001
1000000000000000000000000000000001
1000000000000000000000000000000001
1000000000000000000000000000000001
1111111111111111111111111111111111
